175 64 15
0 0 0 0 0 0 0 0 0 0 0 0 0 0 0 0 0 0 0 0 0 0 0 0 0 0 0 0 0 0 0 0 0 0 0 0 0 0 0 0 0 0 0 0 0 0 0 0 0 0 0 0 0 0 0 0 0 0 0 0 0 0 0 0 
0 0 0 1 2 0 0 0 0 0 0 3 4 0 0 0 0 0 0 1 2 0 0 0 0 0 0 1 2 0 0 0 0 0 0 1 2 0 0 0 0 0 0 1 2 0 0 0 0 0 0 1 2 0 0 0 0 0 0 0 0 0 0 0 
0 0 0 5 6 0 0 0 0 0 0 5 6 0 0 0 0 0 0 5 6 0 0 0 0 0 0 5 6 0 0 0 0 0 0 5 6 0 0 0 0 0 0 5 6 0 0 0 0 0 0 5 6 0 0 0 0 0 0 0 0 0 0 0 
0 0 7 8 9 0 0 0 0 0 7 8 9 0 0 0 0 0 7 8 9 0 0 0 0 0 7 8 9 0 0 0 0 0 7 8 9 0 0 0 0 0 7 8 9 0 0 0 0 0 7 8 9 0 0 0 0 0 0 0 0 0 0 0 
0 0 10 11 9 0 12 0 0 0 10 11 9 0 12 0 0 0 10 11 9 0 12 0 0 0 10 11 9 0 12 0 0 0 10 11 9 0 12 0 0 0 10 11 9 0 12 0 0 0 10 11 9 0 12 0 0 0 0 0 0 0 0 0 
0 0 13 14 15 16 17 18 0 0 13 14 15 16 17 18 0 0 13 14 15 16 17 18 0 0 13 14 15 16 17 18 0 0 13 14 15 16 17 18 0 0 13 14 15 16 17 18 0 0 13 14 15 16 17 18 0 0 0 0 0 0 0 0 
0 19 20 21 20 22 23 24 0 19 20 21 20 22 23 24 0 19 20 21 20 22 23 24 0 19 20 21 20 22 23 24 0 19 20 21 20 22 23 24 0 19 20 21 20 22 23 24 0 19 20 21 20 22 23 24 0 0 0 0 0 0 0 0 
0 25 26 26 26 26 26 26 0 27 28 28 28 28 28 28 0 29 30 30 30 30 30 30 0 29 30 30 30 30 30 30 0 27 28 28 28 28 28 28 0 25 26 26 26 26 26 26 0 27 28 28 28 28 28 28 0 0 0 0 0 0 0 0 
0 31 32 32 32 33 34 35 0 36 37 38 39 37 38 40 0 41 42 43 44 45 45 45 0 41 42 43 44 45 45 45 0 36 37 38 39 37 38 40 0 31 32 32 32 33 34 35 0 36 37 38 39 37 38 40 0 46 0 16 47 48 46 0 
0 49 50 51 51 52 53 54 0 55 56 57 58 56 57 59 60 61 62 63 64 65 65 65 66 61 62 63 64 65 65 65 0 55 56 57 58 56 57 59 0 49 50 51 51 52 53 54 0 55 56 57 58 56 57 59 67 68 67 69 70 71 72 73 
0 74 75 76 76 76 76 76 77 78 79 80 81 79 79 82 83 84 85 85 85 85 85 85 83 86 85 85 85 85 85 85 77 78 79 80 81 79 79 82 0 74 75 76 76 76 76 76 77 78 79 80 81 79 79 82 87 87 87 87 87 87 87 88 
0 89 32 32 32 33 34 35 90 91 92 93 94 92 92 95 96 97 98 99 45 100 101 45 96 97 98 99 45 100 101 45 90 91 92 93 94 92 92 95 0 89 32 32 32 33 34 35 90 91 92 93 94 92 92 95 102 102 102 102 102 102 102 103 
104 89 51 51 51 52 53 54 105 106 107 108 109 110 110 111 112 113 114 114 115 116 117 115 112 113 114 114 115 116 117 115 105 106 118 108 119 110 110 111 104 89 51 51 51 52 53 54 105 106 118 108 119 110 110 111 120 120 121 121 121 121 121 103 
122 123 124 125 125 126 127 127 128 129 130 131 132 130 130 130 128 129 130 130 130 133 134 135 128 129 130 130 130 133 134 130 128 129 130 136 137 130 130 130 122 123 124 125 125 126 127 127 128 129 130 136 137 130 130 130 138 139 140 141 142 142 142 143 
144 145 146 147 148 149 150 150 150 150 151 152 144 144 144 153 154 150 150 155 156 150 150 157 158 158 158 158 159 150 150 160 144 161 150 150 150 150 160 144 144 162 163 164 164 165 158 158 166 167 158 168 150 150 150 150 169 170 171 172 173 173 173 174 
