19 8 7
0 1 0 1 0 1 0 1 
2 2 3 2 2 2 2 2 
2 4 5 2 2 3 2 2 
3 6 7 2 2 8 2 2 
9 10 2 2 2 11 12 2 
13 14 15 15 15 16 17 15 
18 18 18 18 18 18 18 18 
