46 8 7
0 1 2 1 3 4 3 5 
6 7 8 9 10 11 12 13 
14 15 16 15 17 18 17 19 
20 21 22 21 23 22 23 13 
24 25 26 27 28 29 30 31 
32 33 34 35 36 37 38 39 
40 41 42 43 44 41 42 45 
