7 8 7
0 1 0 1 0 1 0 1 
2 2 2 2 2 2 2 2 
2 2 3 2 2 2 2 2 
2 4 5 2 2 3 2 2 
3 2 2 2 2 2 2 2 
2 2 2 2 2 2 2 2 
6 6 6 6 6 6 6 6 
