360 32 30
0 1 2 3 4 5 6 7 8 5 9 9 10 11 5 12 8 5 11 13 10 11 5 12 8 11 2 11 14 5 11 12 
15 16 17 18 19 20 20 21 22 16 23 23 19 20 24 25 26 16 27 28 19 20 20 21 15 16 17 18 19 20 20 21 
29 30 31 32 29 33 33 33 34 35 36 36 37 33 38 39 37 30 33 40 41 33 33 33 29 30 31 32 29 33 33 33 
42 43 44 45 46 47 48 49 50 51 51 52 50 53 54 55 56 57 58 59 46 60 60 61 42 43 44 45 46 47 48 49 
62 33 33 63 64 65 65 66 67 68 68 69 70 71 68 66 72 73 74 75 64 65 65 66 62 33 33 63 64 65 65 66 
76 53 53 77 78 53 53 77 79 79 80 81 82 83 82 84 76 85 86 77 76 87 53 77 76 53 53 77 78 53 53 77 
88 89 90 91 92 93 94 95 96 97 98 99 100 99 100 89 101 102 103 98 104 98 104 89 88 89 90 91 92 93 94 105 
106 107 108 109 110 111 112 107 113 114 115 115 116 115 114 117 106 118 118 118 119 118 118 107 106 107 108 109 110 111 112 107 
120 121 121 121 122 121 121 123 124 125 125 125 125 125 125 126 120 121 121 121 122 121 121 123 127 128 121 121 122 121 121 129 
19 130 24 131 62 30 30 33 132 133 133 133 133 133 133 134 19 130 24 131 62 30 30 33 29 135 24 136 137 30 30 33 
138 53 139 84 140 53 53 139 141 142 142 142 142 142 142 143 138 53 139 84 144 53 53 139 50 53 139 52 145 139 87 87 
64 68 33 146 64 147 148 149 141 142 142 142 142 142 142 143 64 68 33 146 64 147 148 149 150 151 152 153 154 155 156 157 
37 33 33 158 29 33 33 40 132 133 133 133 133 133 133 134 37 33 33 158 29 33 33 40 159 33 160 161 162 161 33 33 
163 164 165 166 167 164 168 169 141 142 142 142 142 142 142 143 163 164 165 170 171 164 168 169 172 173 173 173 174 173 173 175 
176 33 33 33 176 33 33 33 177 178 178 178 178 178 178 179 176 33 33 33 176 33 33 33 180 181 182 181 183 181 181 184 
101 185 186 186 187 186 186 186 187 186 186 186 187 186 186 186 187 186 186 186 187 186 186 186 187 186 186 186 187 186 186 186 
141 143 188 189 190 20 191 91 26 16 192 193 19 20 20 194 15 16 192 16 195 20 20 194 26 16 192 16 196 24 20 25 
124 197 65 75 198 33 33 199 37 30 200 201 78 199 139 53 29 30 33 202 203 33 33 33 204 205 139 206 207 87 199 139 
177 179 208 209 46 210 211 212 213 214 215 216 217 218 219 220 221 222 223 224 225 226 227 228 229 212 230 231 232 220 212 233 
198 65 234 235 29 65 65 75 124 236 237 238 239 240 241 241 62 33 33 242 62 33 33 66 72 73 74 75 243 244 65 65 
245 53 246 84 50 139 247 248 141 249 250 251 252 253 254 255 50 53 87 84 78 53 87 84 76 85 86 77 256 257 258 87 
259 260 71 91 261 262 263 264 132 265 266 267 268 104 267 269 270 262 271 33 272 262 33 135 101 102 103 98 104 98 266 89 
273 274 275 109 110 109 276 107 113 115 115 115 115 115 115 117 110 109 109 109 110 109 109 109 113 114 115 277 278 279 116 280 
281 282 283 284 285 16 16 17 180 181 181 181 181 181 181 184 127 128 121 121 286 121 121 129 287 121 121 288 289 290 121 291 
292 130 24 131 62 30 30 33 141 142 143 293 192 141 142 143 64 135 24 294 295 296 30 33 195 130 24 288 289 297 30 298 
50 53 87 84 144 87 87 139 141 142 143 299 300 141 142 143 101 89 33 301 302 303 33 33 304 305 306 288 289 307 308 291 
29 147 68 309 64 148 71 310 311 312 45 313 33 301 314 315 316 315 317 318 319 166 320 321 67 322 147 180 181 323 324 298 
325 33 33 158 159 33 33 40 326 257 327 328 329 313 33 242 159 33 33 33 325 33 33 149 159 322 330 331 332 282 333 334 
335 336 337 57 338 339 340 59 341 342 343 344 342 343 345 346 347 345 337 337 348 339 349 350 347 322 351 352 353 354 355 356 
357 358 358 358 358 358 358 359 357 358 358 358 358 358 358 359 357 358 358 358 358 358 358 359 357 358 358 359 358 358 358 359 
