42 8 7
0 1 1 2 1 1 1 3 
4 5 6 7 8 9 8 10 
11 12 13 14 15 16 5 17 
18 19 20 21 5 20 22 23 
24 25 26 27 5 5 5 28 
29 30 31 32 5 5 33 34 
35 36 37 38 39 40 38 41 
