260 32 30
0 1 2 1 3 4 1 4 5 4 6 6 7 1 4 4 5 4 1 1 7 1 8 4 5 1 9 1 3 8 1 4 
10 11 12 13 14 15 15 16 17 11 18 18 14 15 19 16 20 11 21 11 22 15 15 16 10 11 12 13 14 15 15 16 
23 24 25 26 23 11 11 11 23 27 28 28 29 11 30 31 29 24 11 32 33 11 11 11 23 24 34 35 23 11 11 11 
36 37 38 39 40 41 42 43 44 45 45 45 44 45 45 45 46 47 48 49 50 51 51 43 36 37 38 39 40 41 42 43 
33 11 11 52 53 11 11 54 23 11 11 11 23 11 11 54 55 56 57 58 53 11 11 54 33 11 11 52 53 11 11 54 
59 45 45 60 61 45 45 62 63 63 45 64 65 64 65 60 59 66 67 60 59 45 45 60 59 45 45 60 61 45 45 60 
68 69 70 11 71 72 73 74 75 76 77 78 79 78 79 69 80 81 82 77 83 77 83 69 84 69 70 11 71 72 73 85 
86 87 88 88 89 88 90 87 91 92 92 92 92 92 93 94 95 96 96 96 97 96 96 87 86 87 88 88 89 88 90 87 
98 99 99 99 100 99 99 101 102 103 103 103 103 103 103 104 98 99 99 99 100 99 99 101 105 106 99 99 100 99 99 101 
14 15 19 107 33 24 24 11 108 109 109 109 109 109 109 110 14 15 19 107 33 24 24 11 23 111 19 70 112 24 24 11 
113 45 45 114 115 45 45 45 116 117 117 117 117 117 117 118 113 45 45 60 44 45 45 45 44 45 45 45 119 45 45 45 
53 11 11 111 53 11 11 120 116 117 117 117 117 117 117 118 53 11 11 111 53 11 11 120 121 122 30 123 124 31 125 126 
29 11 11 127 23 11 11 13 108 109 109 109 109 109 109 110 29 11 11 11 23 11 11 13 128 11 11 11 33 11 11 11 
129 37 37 37 40 37 37 130 116 117 117 117 117 117 117 118 129 37 37 37 131 37 37 130 132 133 133 133 134 133 133 135 
136 11 11 11 136 11 11 11 137 138 138 138 138 138 138 139 136 11 11 11 136 11 11 11 140 141 142 141 143 141 141 144 
80 145 146 146 147 146 146 146 147 146 146 146 147 146 146 146 147 146 146 146 147 146 146 146 147 146 146 146 147 146 146 146 
116 118 148 149 150 15 151 11 20 11 152 153 14 15 15 16 10 11 152 11 154 15 15 16 20 11 152 11 155 19 15 16 
156 157 11 58 158 11 11 159 29 24 160 161 61 159 45 45 23 24 11 162 53 11 11 11 113 163 45 164 165 45 159 45 
137 139 37 166 40 41 42 167 168 169 45 45 113 170 171 35 36 37 37 130 40 37 37 43 172 167 171 173 174 35 167 35 
158 11 175 176 23 11 11 58 156 177 178 120 179 45 45 45 33 11 11 58 33 11 11 54 55 56 57 58 180 178 11 11 
61 45 45 60 44 45 181 166 116 182 11 11 183 45 45 120 44 45 45 60 61 45 45 60 59 66 67 60 136 11 184 45 
185 159 11 11 128 11 34 186 108 187 188 189 190 83 189 191 192 11 11 11 71 11 11 111 80 81 82 77 83 77 188 69 
86 87 88 88 89 88 90 87 193 92 92 92 92 92 92 194 89 88 88 88 89 88 88 88 193 93 92 195 196 197 198 199 
200 201 202 166 53 11 11 12 140 141 141 141 141 141 141 144 105 106 99 99 203 99 99 101 204 99 99 205 206 207 99 208 
209 15 19 107 33 210 24 11 116 117 118 11 11 116 117 118 53 211 19 171 212 213 24 11 154 15 19 205 206 214 24 215 
44 45 45 60 44 45 45 45 116 117 118 216 217 116 117 118 80 69 11 218 219 220 11 11 221 222 223 205 206 224 223 208 
23 11 11 111 53 11 11 120 225 226 39 227 11 218 226 39 225 39 37 130 228 37 229 230 23 231 11 140 141 232 58 215 
71 11 11 127 128 11 11 13 128 11 153 233 234 11 11 58 128 11 11 11 71 11 11 120 128 231 235 236 237 201 166 238 
239 240 47 47 241 242 243 49 168 244 245 246 247 248 249 250 251 240 47 47 241 242 252 35 239 231 240 253 254 255 256 257 
258 141 141 141 141 141 141 259 258 141 141 141 141 141 141 259 258 141 141 141 141 141 141 259 258 141 141 259 141 141 141 259 
